+-------+-------+---------+----------+
|       |       |         |          |
|  +--+ | +---+ |  +----+ | +-----+  |
|  |  | | |   | |       | |       |  |
|  +  | | | +-+ +----+  + +-----+ |  |
|     | | | |                     |  |
+-----+ + + +---------------------+  |
|     |     |                        |
|  +  +-----+   +------------+----+  |
|  |                         |    |  |
|  |   +---------------------+    |  |
|  |   +-----------------------+  |  |
|  |                              |  |
|  +-------------------------+    |  |
|                            |    |  |
+---+                        |    |  |
|   |   +--------------------+    |  |
|   |                             |  |
|   +----+    +                   |  |
|        |  +-+   +   +--+--------+  |
|        |  |     |   |  |           |
|        |  |     |   |  |           |
|        |  |     |   |  |   +--+----+
+-----+  +  |     |   +  |      |    |
|           |     |      |   +  |    |
|   +-------+---+ |   +  +---+  +    |
| X |             |   |              |
+---+-------------+---+--------------+